 -1 -1 -1 -1 -1 -1 -1 -1 -1 -1 -1 -1 -1 -1 -1 -1 -1 -1 -1 -1 -1 -1 -1 -1 -1 -1 -1
 -1 30 30 30 30 30 30 30 30 30 30 30 30 -1 30 30 30 30 30 30 30 30 30 30 30 30 -1
 -1 30 -1 -1 -1 -1 30 -1 -1 -1 -1 -1 30 -1 30 -1 -1 -1 -1 -1 30 -1 -1 -1 -1 30 -1
 -1 29 -1 -1 -1 -1 30 -1 -1 -1 -1 -1 30 -1 30 -1 -1 -1 -1 -1 30 -1 -1 -1 -1 29 -1
 -1 30 -1 -1 -1 -1 30 -1 -1 -1 -1 -1 30 -1 30 -1 -1 -1 -1 -1 30 -1 -1 -1 -1 30 -1
 -1 30 30 30 30 30 30 30 30 30 30 30 30 30 30 30 30 30 30 30 30 30 30 30 30 30 -1
 -1 30 -1 -1 -1 -1 30 -1 30 -1 -1 -1 -1 -1 -1 -1 -1 -1 30 -1 30 -1 -1 -1 -1 30 -1
 -1 30 30 30 30 30 30 -1 30 30 30 30 30 -1 30 30 30 30 30 -1 30 30 30 30 30 30 -1
 -1 -1 -1 -1 -1 -1 30 -1 -1 -1 -1 -1 -1 -1 -1 -1 -1 -1 -1 -1 30 -1 -1 -1 -1 -1 -1
 30 30 30 30 30 -1 30 -1 -1 -1 -1 -1 -1 -1 -1 -1 -1 -1 -1 -1 30 -1 30 30 30 30 30
 -1 -1 -1 -1 -1 -1 30 -1 -1 -1 -1 -1 -1 -1 -1 -1 -1 -1 -1 -1 30 -1 -1 -1 -1 -1 -1
 30 30 30 30 30 30 30 -1 -1 -1 -1 -1 -1 -1 -1 -1 -1 -1 -1 -1 30 30 30 30 30 30 30
 -1 -1 -1 -1 -1 -1 30 -1 -1 -1 -1 -1 -1 -1 -1 -1 -1 -1 -1 -1 30 -1 -1 -1 -1 -1 -1
 30 30 30 30 30 -1 30 -1 -1 -1 -1 -1 -1 -1 -1 -1 -1 -1 -1 -1 30 -1 30 30 30 30 30
 -1 -1 -1 -1 -1 -1 30 -1 -1 -1 -1 -1 -1 -1 -1 -1 -1 -1 -1 -1 30 -1 -1 -1 -1 -1 -1
 -1 30 30 30 30 30 30 -1 -1 -1 -1 -1 -1 -1 -1 -1 -1 -1 -1 -1 30 30 30 30 30 30 -1
 -1 30 -1 -1 -1 -1 30 -1 -1 -1 -1 -1 -1 -1 -1 -1 -1 -1 -1 -1 30 -1 -1 -1 -1 30 -1
 -1 29 30 30 30 -1 30 30 30 30 30 30 30 30 30 30 30 30 30 30 30 -1 30 30 30 29 -1
 -1 -1 -1 -1 30 -1 30 -1 30 -1 -1 -1 -1 -1 -1 -1 -1 -1 30 -1 30 -1 30 -1 -1 -1 -1
 -1 30 30 30 30 30 30 -1 30 30 30 30 30 -1 30 30 30 30 30 -1 30 30 30 30 30 30 -1
 -1 30 -1 -1 -1 -1 -1 -1 -1 -1 -1 -1 30 -1 30 -1 -1 -1 -1 -1 -1 -1 -1 -1 -1 30 -1
 -1 30 30 30 30 30 30 30 30 30 30 30 30 30 30 30 30 30 30 30 30 30 30 30 30 30 -1
 -1 -1 -1 -1 -1 -1 -1 -1 -1 -1 -1 -1 -1 -1 -1 -1 -1 -1 -1 -1 -1 -1 -1 -1 -1 -1 -1